#
##########
#
#
#
#
#
#
#
#
#########
nombre de briques : 
195
#
design du niveau
O;O;O;O;O;O;O;O;O;O;O;O;O;
O;O;O;O;O;O;O;O;O;O;O;O;O;
O;O;O;O;O;O;O;O;O;O;O;O;O;
O;O;O;O;O;O;O;O;O;O;O;O;O;
O;O;O;O;O;O;O;O;O;O;O;O;O;
O;O;O;O;O;O;O;O;O;O;O;O;O;
O;O;O;O;O;O;O;O;O;O;O;O;O;
O;O;O;O;O;O;O;O;O;O;O;O;O;
O;O;O;O;O;O;O;O;O;O;O;O;O;
O;O;B;A;A;A;A;A;A;A;B;O;O;
O;O;O;A;A;B;C;B;A;A;O;O;O;
O;O;O;C;B;A;A;A;B;C;O;O;O;
O;O;O;O;O;O;O;O;O;O;O;O;O;
O;O;O;O;O;O;O;O;O;O;O;O;O;
O;O;O;O;O;O;O;O;O;O;O;O;O;
;
